Brokeback Mountain nhận 8 đề cử Oscar

Phim Brokeback Mountain đã nhận được những đề cử quan trọng như Phim xuất sắc nhất, Đạo diễn xuất sắc nhất, Nam diễn viên chính/phụ xuất sắc nhất và Nữ diễn viên phụ xuất sắc nhất. 
Theo sát Brokeback Mountain là các phim như Crash , Good Night and Good Luck và Hồi ức của một Geisha (6 đề cử) rồi đến Capote , Walk the Line, Munich (5 đề cử). 
Ở các giải cá nhân, George Clooney là người nhận được nhiều đề cử nhất với 3 đề cử ở 3 lĩnh vực khác nhau: diễn viên phụ xuất sắc nhất, đạo diễn xuất sắc nhất và kịch bản xuất sắc nhất. 
Nhiều khả năng phim Brokeback Mountain sẽ có được 2 tượng vàng Oscar quan trọng nhất là Phim xuất sắc nhất và Đạo diễn xuất sắc nhất. Ở những giải tiền Oscar, Brokeback Mountain đã giành chiến thắng gần như tuyệt đối ở hạng mục phim xuất sắc, còn đạo diễn Lý An thì giành được 5 giải (trong đó có giải Quả Cầu Vàng và giải thưởng của Hiệp hội đạo diễn Mỹ). 
Sau đây là danh sách đề cử giải Oscar lần thứ 78: 
Phim xuất sắc nhất: Brokeback Mountain, Capote, Crash, Good Night and Good Luck, Munich. 
Đạo diễn xuất sắc nhất: Lý An (Brokeback Mountai), Bennet Miller (Capote), Paul Haggis(Crash), George Clooney (Good Night and Good Luck), Steven Spielberg (Munich). 
Nam diễn viên chính xuất sắc nhất: Philip Seymour Hoffman (Capote), Heath Ledger (Brokeback Mountain), Terrence Howard (Hustel &amp; Flow), Joaquin Phoenix (Walk the Line), David Strathain (Good Night and Good Luck). 
Nam diễn viên phụ xuất sắc nhất: George Clooney (Syriana), Matt Dillon (Crash), Paul Giamatti (Cinderella Man), Jake Gyllenhaal (Brokeback Mountain), William Hurt (A History of Violence). 
Nữ diễn viên chính xuất sắc nhất: Judi Dench (Mrs.Henderson Presents), Felicity Huffman (Transamerican), Keira Knightley (Pride &amp; Prejudice), Charlize Theron (North County), Reese Witherspoon (Walk the Line). 
Nữ diễn viên phụ xuất sắc nhất : Amy Adams (Junebug), Catherine Keener (Capote), Frances McDormand (North County), Rachel Weisz (The Constant Gardener), Michelle Williams (Brokeback Mountain). 
Kịch bản gốc: Crash, Good Night and Good Luck, Match Point, The Squid and the Whale, Syriana. 
Kịch bản chuyển thể: Brokeback Mountain, Capote, The Constant Gardener, A History of Violence, Munich. 
Biên tập phim: Cinderella Man, The Constant Gardener, Crash, Munich, Walk the Line. 
Hiệu quả âm thanh: The Chronicles of Narnia: The Lion, the Witch and the Wardrobe, King Kong, Hồi ức một Geisha, Walk the Line, War of the Worlds. 
Hiệu quả hình ảnh: The Chronicles of Narnia: The Lion, the Witch and the Wardrobe, King Kong, War of the Worlds 
Đạo diễn hình ảnh: Good Night and Good Luck, Harry Potter and the Goblet of Fire, King Kong, Hồi ức một Geisha, Pride &amp; Prejudice. 
Quay phim: Batman Begins, Brokeback Mountain, Good Night and Good Luck, Hồi ức một Geisha, The New World. 
Phim nước ngoài: Don't Tell, Joyeux Noel, Paradise Now, Sophie School - The Final Days, Tsotsi. 
Bài hát trong phim : In the Deep (Crash), It's Hard Out Here for a Pimp (Hustle &amp; Flow), Traveling Thru (Transamerica). 
Âm nhạc: Brokeback Mountain, The Constant Gardener, Hồi ức một Geisha, Munich, Pride &amp; Prejudice. 
Phim ngắn: Ausreirra (The Runaway), Cashback, The Last Farm, Our Time Is Up, Six Shooter. 
Phim hoạt hình: Howl's Moving Castle, Tim Burton's Corpse Bride, Wallace &amp; Gromit in the Cruise of the Were-Rabbit. 
Phim hoạt hình ngắn: Badgered, The Moon and the Son: An Imagined Conversation, The Mysterious Geographic Explorations of Jasper Morello, 9, One Man Brand. 
Thiết kế trang phục: Charlie and the Chocolate Factory, Hồi ức một Geisha, Mrs.Henderson Presents, Pride &amp; Prejudice, Walk the Line 
Phim tài liệu: Darwin's Nightmare, Enron: The Smartest Guys in the Room, March of the Penguins, Murderball, Street Fight. 
Phim tài liệu ngắn: The Death of Kevin Carter: Casualty of the Bang Bang Club, God Sleep in Rwanda, The Mushroom Club, A Note of Triumph: The Golden Age of Norman Corwin. 
Hóa trang : The Chronicles of Narnia: The Lion, the Witch and the Wardrobe, Cinderella Man, Star Wars: Episode III Revenge of the Sith.

KINH LUÂN
